###########################
###########################
#################...#######
#################.#.#...###
###############...#...#.###
##############..######..###
#######...###..####.s..####
#######.#.###.#####.#######
#######.#.##..##....#######
#######.#....###.###...####
#######.########.....#.####
#######.#.....#######..####
#######...###.###...#.#####
############..##..#...#####
############.###.##########
####e#######....###########
####..#########.###########
#####.#########.###########
###...#########...#########
#...#############..########
#.################.########
#..##############..########
##...############.#########
####...####...###.#########
######..#...#.###.#########
#######...###.....#########
###########################
