###########################
###########################
###########################
###########################
###########################
###########################
###########################
###########################
###########################
###########################
###########################
##########....e############
#########.s################
#########.#################
#########..################
##########.################
##########.################
#######....################
#######.###################
#######.#..################
#######.##.################
#######.##..###############
#######..##...#############
########.####..############
########.....#.############
############...############
###########################
