#######
#.##.##
#e....#
##.#.##
#..#.##
##.#s.#
#######
