##################################################
#e.#.#...#....#........#..............#..........#
#....#........#........#.........................#
#.............#.......................#..........#
#..#.#.#...##.#.###.##.#.###..#...............#..#
#..#...#.#..#.......#..#.........................#
#...#.##...##...###..#.#.##............#......#..#
#..#..##.#.##.#.#....#.....#.......#...#.....#...#
#...#.##.#.##.#.###......#.........#.........#...#
#..##..#.#......#.#####..##............#......#..#
#...#..#...#....##........#...#....#...#.....##..#
#....##....#..#.#..#..##........#.........#......#
#..#..##.........#..#.#...#......................#
#....#...#.......#.....#........#.........#......#
#..#.###.#......##.#.#.#..#.#.#.##.#.###.#..#.#..#
#......#.#.........#.#.#....#.#.##.#.###.#....#..#
#..##..#....#..###...#......#...##.#.###...##....#
#..##..#.#..#..#...#...#.....#..##.#..##.#.##.#..#
#....#......#........#...........#.#.###...#..#..#
#..###.#.......#.#.#.#.#........#..#.###.#....#..#
#..##..#.#......#..#...#.....###...#.#....###.#..#
#..###.#..###..###.#..........##.#.#.##..........#
#..#.....#......#..#...#..#.##.#.#...#.#.#.......#
#..###.#.##......#.#...#......##...#...#####..##.#
#..###.#.###....#..#.#....#..##....#.#..##.......#
#..###.#.####....#.#...#..#.#.........#..#.#...#.#
#..###.#.#..#...#..#.........###.#.#....#..#...#.#
#..###.#.###.....#.#.#...........#....#..........#
#....#.#.##.....#..........#.....#....####.#.....#
#..###.#..#####....#.#................#..........#
#..###...#.........#...#.###....#..##............#
#..#.#.#.#.......#.#.#.#..#..#....#.....##..#.#..#
#....#.#.#..###....#.#...#.#....#...#.#.......#..#
#..#.#.#.##......#.#...##....#....#.#.##....#.#..#
#..#.#.#..#..#...#...#.....#....#..#..#..#..#....#
#..#.#.#....##.#...#.#....#..##.#.####.....##.#..#
#..#.#.#....#......#.#.##.##...........#.........#
#..#.#.#.#...#.#...#...##.#...#......#.....#.....#
#..#.#.#....##.#.#.#.#....##..#.#..#.###.#..###..#
#..#.#.#...#.#...#...................#.......#...#
#..#.#.#.#.#.#.#.#....#.........#..#.....#.......#
#..#.#.#.#...#...##.#..#..##...........#.#..#.#..#
#..#.......#...#.#....#..........#.#...#....#....#
#..#.#.#..#.##...##..#..........##.#.#...#....#..#
#....#...##.#..#...##.....##...........#.........#
#..#...#.#..##.#......#......#..#..#.#...#..#.#..#
#..#.#.#.#..#..#.##..#.......#.......#...........#
#..#.#.#..#......###.........#...........#.......#
#..#.#.#.#...#.#.###.#...............#..........s#
##################################################
