##########
#.####.#.#
#e.###.#.#
#.###..#.#
#.####.#.#
#.####...#
#.##...#.#
#.#.#....#
#........#
#.#......#
#..###.#.#
#.#......#
#.#.#..#.#
#.#....#.#
#...#..#.#
#.#.#....#
#.#....#.#
#.#.#..#s#
#.#.#..#.#
##########
