##########
#e.#.....#
#........#
#..#.#...#
#..#.....#
#....#.#.#
#..#.#.#.#
#..#.#...#
#..#.#.#.#
#..#...#.#
#..#.#.#.#
#..#.#.#.#
#..#.#.#.#
#..#.#.#.#
#....#.#.#
#..#.#.#.#
#..#.#...#
#..#.#.#s#
#..#.#.#.#
##########
