##################################################
#e.#...................##...#...#.#.#...#.#.#..#.#
##..#.#.#.#.#.#.#.#.##....#..##.......#.......#..#
#.#..#.#.#.##..#.#....####.#....######.###.##...##
#.##.........##...###.#.....####..........#.###..#
#...##.#####..#.#...#.#.###.#....#######.#.....#.#
#.#..##....##...###.#.#....#..###......#...###...#
#..#....##...###..#...#.##...#....#.##..####..##.#
##..##.#..##...#.#####....###.##.#...##.....#...##
#..#..#..##.##....#...###.#.....##.#...####...#..#
#.##.#..#.....###...#...#...###.#...##.#...###.#.#
#......#..###.#..##.####.###..#..###...#.#.......#
##.###..#.#...#.#.#........##..#.....#.#..########
###....#..#.###....#####.#...#..#####.#.#.#......#
##..#.#..##....#.#......#.##..#............#.###.#
#..#.#..#..###..#..#.##.#...#...#.####.####..#...#
#.#....###.#..#...###.#...#..###.#....#.....#..###
#...###.##...#.###.#...#.#.#.#.....##...##.#..#..#
####.......#.........#.##....#.#####.#.#.##..#.#.#
#....######.####.##.#.#...####.......#.....#.....#
#.###...........#.#.....##....######..####..####.#
#.....##.######.#.##.#.#...##........#...#.#.....#
#########.......#...#.#..##.###.######.##..#.#####
#.....##..##.###.##.....#......#.......#..#..#...#
#.###....#..##.....#.#.#.###.#...##.#.#..#..#..#.#
#...#####.#....###.##.........###....#..#..#..#..#
###.......#.#.#..#...#########....##.#.#..#.####.#
#.####.#.#..#.#.#.##..........#.#...#..##.....#..#
#....#..#..#..#......#####.##..###.#..#..####..#.#
##.##.#..#..#..####.#....##..#..#.##.###.....#.#.#
##....##..#.##.....#..##....#.#......##..###...#.#
#..##....#....#.##.#.#..#.##...######...#...####.#
#.#..#####.##..#...#..#..#...#........##.##.#....#
#...#.....#..###.####..#...##.#.#.#####.......##.#
##.#..#.#...#....#.#.#...##.#..#.#......######...#
#..#.#...##...###......##....#.....###.#.......###
#.#.#.##.#.###....##.##...##.####.#...#..#######.#
#........#.....##.#.#...##.#......#.#..#.........#
#########..####..#...#.#....##.###..##..########.#
#.........#....#...#.#..#.#...#...#...##.........#
#.###.####..##.#.##..##..#..#...#...#....###.###.#
#....#.....#...#.#..#.##.##..#.#.#.#.#.#....#...##
#.#.#..####..##..#.#.......##.....#...#.#.#...#..#
#.#...#.....#..#.#..##.#.#...#####..#.#..#.#.#.#.#
##.###..#####.#...#...#...##.......#...#....#...##
#.....#.........##.##.###...#.##.###.#...##...#..#
#.#.#..#.#.#.#.#....#....####...#...##.###.#.#.#.#
#.##.##.#.#.#.#.#.##.###.....###..#...##....##...#
#........................#.#.....#..#....##....#.#
##################################################
