############
#....#.#####
####....####
#...#.######
###.....####
#...#.#.#.##
#s###.#....#
##...#.#.###
###.#......#
##..e.#.#.##
####.#..#..#
############
