####################################################
#.###..##...#.##...#..#....#...#.#.#....#....#.##.##
#..#.#....##....#.#.#.#.#.#.##...#...#.#..##.#.....#
##.#..###...#.#.....#.#.##...##.#.#.#.#.#.#.#..#.#.#
#....##..##.##..###.#......#................#.#...##
##.#.#..#.#..#.#..#...##.#..#.##.##.#.#.#.#...##.#.#
###...#.#..#..###.##.#..###.#..#..##..#..##.#...#..#
##.#.#...#..#..#...#..#..#.#.##.#...#..#.#.#.###..##
#..#.##.#.#...#.##...#..#.......#.#.#.###....#.##.##
#.#.....#..##.....##.##..##.#.#..###.#.#..###......#
#..##.#..#.###.##......#....##.##.#......#..#.#.##.#
##.###.#....#.#..##.#.##.##.....#...#.#.###.#..#..##
#...#..#.#.##..#.#.#......#.#.##.#.#..#####...#.#..#
##.#.#.#.#...#...#.###.#.#..#..#...##...##..#.#..#.#
##......#.##..#.##......##.#.###.#..#.##..#..#..#..#
#..##.##..#.#...#.#.##.#..##.#....##.##..#..#.#.##.#
##.#..#.#....##....#.....#....#.##.#.#..#..#.......#
#.#.#.....###..#.##.##.##..##.#..#....#..#.#.#.##.##
#.....#.#.#...##.#.....#..#..#..##.#.#.#.....#.#...#
####.#..#.#.#......#.#..#..#.##.#...#..#.#.##.#.#.##
#....#.#...#..#.#.#.#..#.#.......##..#.##........#.#
##.#.#####..##.#.#...#.#...#.#.##...##....#.##.#...#
#...#..#...#.#....##....#.##.##..##.#.#.#####.#.#.##
##.##.#..#...###.##.##.#....#..#..#.......#...#.####
#..#...#..#.#..#.#......#.#...#..#..#.#.#...#.....##
#.#.##..##..#.#....#.#.#...#.##.#..###..#.#..#.##..#
##...#.#..#.#..#.#.#.#...##.##....#.#.#.##..#....###
#.#.#...#...##..#.#.#.##......##.#.....#..#..#.#...#
#....#.#.##..#.#.........####.....##.#...#.###..#.##
#.##......##.#...#.##.##.....##.#.....##......#..#.#
#..#.##.#......##..#....#.#.#....##.#...#.#.#..#...#
####################################################
