##################################################
##......#.#.#..#.##.#.#...#...#.#..#...##.....#..#
#.#.#.##...#.#...#.##..##...#....#..##.#.##..#...#
###..##..#...##.....#..##.###.###.#....###...###.#
##........#..##..##.###...#.....#.#.#...#.....#.##
##.#..#....#..#....##.#.##.####.##...#...#..#..#.#
##...#..##..#..##.#..##.##..#.#.....##....#.#....#
#.#..#..###..#.#..###.#..............####.#..#.#.#
#..##.#.#.#.##.#..#..##.#.#..###...#.....#..#.#..#
#...#.....#...#..#.....#....##.##.##.###.....#..##
#..#......#...#.#.....#.##..#..#.##..#......#.##.#
##.###...####.#.#..###..#...#......#.######.##..##
#.#.##.##..#.##....#..#..#.#..#...#.....#.#....#.#
##.....##...#..###.....##.#.##.####.#.#..#..##..##
##.#.#...#.#....#..##.....#....##..#.#.#..#.#..#.#
###.###.###..#.######..#.....#...#.....##.....#..#
##...#....##..#..#.#..#.##.##.#..#.#.##.##.#.###.#
#.........#.##...#..#.....#...###.#....#.#..##...#
##.##..#..#..#.##..##.####..#.#.#..##.##......##.#
#....#..##.##..#.#...#.....#......#..#...#..#....#
#...#..#......#.#..#....#.#....#...#.#.####.....##
#.##....##....#..#.#.....###.#.....#..#.#..##.#..#
##.##.....#....#.#..#####.....#.#..##.##....#.#..#
##...#..#.##..#.#..##.#.##..#..#.#...##..##...##.#
##.#.#..##..#.#..#...#.#.#....#..##...#..#..##..##
#.#.#.##..##..#.#..##.#..#...#.#.#.##.#...#.#.#..#
#.##.....#...#......#....#.........#.#..#.#....#.#
#.##.#..#..#.#...#.#..#.#.#.#...#..###.#..##..##.#
##.#.#...#.#..##.#..###......#...##..#..###......#
##..##.##.#..#...##.#.#.##.#..####.....#...#.##..#
#.#.#.#............#..#.#..#.#.#...###..###.#....#
#...#.................##..#...##....#...#...#.#..#
#.#.##..##.#.###.####...##....#.#..##.....#####..#
###.#.#.#.#.#.#.##...#...##.#.#.#..#.#...##..#.#.#
#...#.#.............#.####.##...#.###..#.#.#.#...#
##.####..#..#...#......#.#...#.#......#....#.##..#
#.#...#.###.#.....###.......#..##........##..##..#
#......#....######...######.##....####...........#
##.....#..###..#...#...#...#..#.......#...#..#...#
##...###.###....##..#..#.##....##....#.####...#..#
#.#.##..#.........##..##..#.####.###.#.#..##.#...#
#.#...##....#...#.##.#.#..##.....##.#.#..#...##..#
#.#.#.#..#.........#..##...##....#.#.#.#...#.#.#.#
#...#.#..#####..#..#....###....##.....#...#...#..#
##...#..##.##...###.###..##..##.....##...#.###...#
##.....#...#..#.#.##...##..#..#..#.##..##..#..#..#
#.#....#...##..##...#.##..#.#..#.....##.#..###...#
#.#.##.#.##..#...#..#.#...##.###.......#.#.......#
##.#..#..................#..#...###.......##.##..#
##################################################
