##################################################
###.#.#####.###.################.#################
###.#.##.#.#....................#.......###.#.####
###.#.##.#.#....................#.......#..##.#..#
###.#.##.#.#######.############.###.#####..#.###.#
###.#.##.#.####.###############.#..#....#...#....#
###.#.##.#.#...#...............##..#....#..##.#..#
##..#.##.#.#...#...............####.#####..##.#..#
###...##.#.#####.################..#....#...######
###.#.##...#...#...............##.......#..##....#
##.#####.#.####.######################.#####.###.#
###...###.##...........................##.#..##..#
###..#...#.##.#########################.#.#...#..#
###.#.##.#.#...........................##.#..##..#
#####.##.#.#.............#.............##.#..##..#
###.#.##.#.##################.##.####..##.#..##..#
###.#.##.#.####.#######..#.##.#.#....#.##.#..##..#
###.#.##.#.#...........#..#..#..#####.###.#..##..#
###.#.##.#.############.###..##.#....#.##.#..##..#
###.#.##.#.#.##.#...#..###.####.###.##.##.#..##..#
###.#.##.#.#.###.##.#..####.#.#.#..#...#..#..##..#
###.#.##.#.#.##.#...#..#####.##.#.#######.#..##..#
###.#.##.#.#.##.##..#..####...#.#..##..##....##..#
###.#.##.#.#.##.##..#..###.###..#..#...##.#..##..#
###.#.##.#.#.##..###...###....#....#.#.##.#..##..#
###.#.##.#.#.##.##..#..###....#.#.#####.#.#..##..#
###...##.#.#.##.##.....##################.#..##..#
###.#.##.#.#.##.##..#..###.####.#......##.#..##..#
#####.##.#.#.#######...#####..#..############.#..#
####...#.#.#.##.#.#.#..#####....#..##..##.#.#....#
##.#.#.#.#...##.#.#.#..####...#.#..##..##.#.#.#..#
###...##.#.#.#..##..#..#####..#.#..##..##.#.#.#..#
###.####.#.#.##.#.#.#..###.#..#.#..##..##.#.#.#..#
####..##.#.#.##.#.#.#..#####..#.#..##..##.#.#.#..#
####..##.#.#.###..###..####.###.#..##..##.#..##..#
#..#...#.#.#.##.##..#..##.######...##..##.#.#.#..#
#######..#.#.##.#..##..###..#.#.#..##..##.#.#.#..#
##.....#.#.#.##.#..##..###..#.#.#..##..##.#.#.#..#
##...#.#.#.#.##.#...#..###..#.#.#..##..##.#.#.#..#
#####.##.#.#.##.#..##..###..#.#.#..##..###.###.###
###..#.#....#.##.####..###....#.#..##..###....#..#
#.###..#.#.#.#......#...####.##.#..##..##.#####..#
###..#.#.#.#.#......#..###....#.#....#####....#..#
##...#.#.#.##.#######.####..#.#.#......##.....#..#
#####.#.##.#########.#############################
#..#...#..........#..............................#
#...#..########.##.###########.###################
#..#.###..........#..............................#
###.##.#..........#..............................#
##################################################
