##########
#s.#.##..#
#..#.##..#
#..#..#..#
#....#...#
#....##..#
#..#..#..#
#....#...#
#..#.##..#
#..#.##..#
#..#.##..#
#..#..#..#
#..#.#...#
#..#.##..#
#......#.#
#..#.#...#
#..#.#.#.#
#......#.#
#..#.#..e#
##########
