##############################
#e...........................#
#.#.#.#...#.#...#......#..#..#
#.#.........##..#......#..#..#
#.#.#........................#
#.#.#.#..##..##.....##..#....#
#.#.#.#.....#.....##...#..#..#
#.#.#...#...#.....####.......#
#.#.#.#.##...##...#..#..#....#
#...#........##....##.....#..#
#.#.#...##..###..............#
#.#.#.#.##..###..............#
#.#.#.......###.#..#...#..#..#
#.#.#.#......#............#..#
#...#........................#
#.......#................#...#
#.##.##......................#
#.##.#...................##..#
#..#....#................#..s#
##############################
