##################################################
######..#.##..#######.##############.##.####.#####
##..#.#.####......#.####.#.##.#.#.##..##....#..s##
###..###.##.#.#.#..#.##...#.#..###.###.###.###..##
##.####.####.#####.##.##.#.##..##..#..#.####.###.#
##.###..#####.####..##.###..###.#..##.##..##..#.##
#.#...#..###.#.##..##.#.###.#..####..#...###.#####
####.######.##.#....##..#.#..#.###.#..##.....#..##
##.#.###.###.#.###.##.####..#..#..##.##...##.##.##
####.###.###.#.##.####.###.######..##.####.#.#.###
##...#.#.##.##.###.#.##..#.#.##.######.####.######
#.#####.#.###.##.#..#..#####.#.##..##.###.#.###.##
#.....#####..#.##..##..###..#.#####.###..#.#.#.#.#
#..#..###..##.##.##.#####.###.#.###....#####..#.##
###.##...####.##....##..###.#..###.##..###..##..##
#.#.###.#.#...###.#######.#..##.#.#####..###..####
##..#.####..##.###..###########.######.##...#.####
#..##..#.#.##.##..#.#.#.##.###.###.##.#######...##
#######..##....##.#.#.#.#.#.#.#.#.##.#...#.##.##.#
#....##..##.##.#.#.##..####..#.##.####.##.#..##.##
##.#...##.#############..##.####.#########.#...###
###.###.#.##########.###.####.#...##..#.#####.#.##
####.####.#############.#.#..####.#..###..#.#.####
##.###...####.##########.####...#####.##.##.#..###
######.##.###########.#...##..#.#.##.####...##.###
#...###...#.##.###..##.##.#.##.#.##.###..###.##.##
#.####.#.###..#..##.#..#...#.##.######.##.##..##.#
#...#...#######.#.#...###.###.#.####.##.#...##..##
#.##.#####..########.###..#.#.#.#...#.##.###.##.##
##.####.#####.#.##.#...#.##.#.##..#.##..###..##.##
#####.#.#.####.###..#.########.####.##.#.#..#...##
##..##.##.##.##.####.##...############.###########
###..#.#.#####.####.#.####.#.##....#####.##...####
#.#.####..#####..#.#.#####.###.###.####.##.#.#.###
####.###.#.##.#.#.#..######..####.#.##.####.#.####
##.#.###.#.###....#.#..#...#.####.####..######.###
####......##########.#.##.#.####.#.#..#..#....####
#.##.##.#.##.##...##.#.#####.#.#..#..#.#.##.##.###
#.##.##.#.#....###.##.#.#..#.#####.####.#.#.######
##.#..#.##.#..#######.#..#####..####.##.####..#.##
######.###..###...#######.#####.....####.##.######
##.#.##.#.#.#.#.####.####...#.#.###..#..#...######
##.##..##.##.###.#.######.#..###..#.###.#####..###
##..#.#.#.##..##.##.####.#.####....########.#..###
#..##.#.##.##..##.#....##.###.####...#..###..##.##
###.#.#.##.#..##.####..##..#.#.###...###..##.#####
#..#.#####..####....###.##.##.#...##.#.#.#....#.##
###..#.#.###...#.#.....#.##.######.#####..####.###
#e################.###############################
##################################################
