############
#e.#....#..#
#.#.#.###.##
#.........##
#.#.#.##.###
#..#.#...###
#.##.###..##
#.#...#.#..#
#..##.....##
#.###.#.#.s#
######...#.#
############
