.####.#####..#..#####.#
..##.##..####..##.####.
###.##...#.#.###.#.###.
#.######.########..##.#
#########.##..#########
#####.#..#########.###.
###.#.#.##########.#.#.
###..##..######..####.#
#.###.###.##..#.#.#.###
##.##.##.##.##########.
.#####...#.###.########
.####.#.##.#######.####
.####.#.#########.#####
.##..###.#.##.#.####.##
.##########.###.###.#..
.##.#.####.#.#.###.####
.####.##########.##..##
.###########.##.###.###
.###############.##.###
..#####.##..###.#.#..##
.#.#.#.#.##.#.#.##..###
.#.#####....##..##.###.
.#####..#####.##.#..#.#
