#########################
#e.########.##......#...#
#..#.#.#...#.##.....#...#
#..#.#.####..##.....#...#
#..#.#.#..##..######..###
#..#.#.#..##.###.####...#
#..#.#.#.#.#.##.#...#...#
#..##.#####..##...###...#
#..#.......#.##.##......#
#..#.#.....#.#.######.###
##..#################.###
#..#........#.#..##..#..#
#..#........##.#...##...#
##.######.#.##.#.##..#..#
#..#.....#...#.#.######.#
#..######.##########.####
#..#.....#..##..######.##
#..#.....#..##....#...#.#
############.#..###.....#
#####.#####.##..##.###..#
#.##........##..###..##.#
#...#...#...##..###...#.#
#...####.#.###..##.####.#
#...##..#...###..##...#s#
#########################
