###########################
###########################
###########################
###########################
###########################
###########################
###########################
###########################
###########################
###########################
###########################
################...########
################.#.########
#####...########.#....#...#
#####.#.########..###...#.#
#####.#..#...####.#..####.#
#e###.##.#.#.####..#......#
#.###.##...#..####.########
#..#..#######..#...########
##.#.#########...##########
##.#...#....###############
##.###...##.###############
#..########s###############
#.####...#..###############
#...##.#.#.################
###....#...################
###########################
