##################################################
##.#..##.##.###.##..#..##..#.#..#.###.############
##.###..#..#..##..#..##...##.###...###..#.#.##.###
#.#.#.########.#.###..##..########.#..###..#.#####
#..#####.#.###.####.#.####.#.#.###.#.###.##.#.#.##
##.#....#.#.#.######.#...#..#.#...##..#.###.#.####
##.#.....##.#######...###.##.##.#..###.#.##.##.###
#.#.##.####.#.....##.###.##.####..##.####.#.##.###
###.#..#..#.##.#.###..#.#...###.#..####..##.##.###
#.##.#.##...#.###..###.#.##..##.#.#.#..#.###..#.##
#..######.#####..######.##.######.##.#.#.###..####
#.#.#####.##.####.#...#..#.#.##.#..###.#.####..###
##..#..##.#.##..#####.###...#...#.#....#.#..##.###
#.##.#.##.##.#.#.#...##.##.#.#.#..###.#..###.#.###
#######..#.###.######..################.##########
##.#..#..#......##.#.##.#..###.####.#.#.##.#######
##.#.#.##.#####.#..#...#.#..###.#.#####........###
##...#.#.#.###.###..##.#.##.#.....##.##.##...#.###
#.###.#.#..#..#.#######.####..####..#########.####
#.#.#.#.##.###.#########.#..####.####.##.######.##
##.##..######..###.#.#....####.#.###.########.####
#.#.##.#....##.###.#.#####..#.##.#..#.#....#.#.###
##...#..##.#.#.####.##.#####.##.#..#.#####.#..#.##
##.##.#.##.##..######.#.#.##.##.#.#.##..#..##.#.##
#.#..#.#.#.#...###...#.##...#####...#.##....#..###
##.#.#.##....#..#.#.######.#..######.##.####.##.##
###############.#####.######..######..##.#########
##...#.#.###.###....##.###.#.#..##.##.#########.##
#..#..###..##.##...###.###.#.##.#.#..#.##.##...###
##.#####..###.#.####.#...###..#####.###..##..##.##
##.#..####.##...#.###..##...#....#...##.#..#######
#.#..##.###.##.#.###.#.##############.##.#.#..####
#.#######....##.######.########.###.###.#.###.####
##.###..#..##.##.#.##.#.##..#.##......#.##..######
#.####.#..##..###.#.##....##..####.##.##...#..####
##..#.###.#..##...#.#...##.#.####.#...###.####.###
##.#.#..#..#.###.#..#####.###.##.#.###.##.#.##..##
###.#######.#..#####..#.#######..###..###.#..#.###
##.##..#####....##..#..##...#.###..###.###.##..###
#.#.###....##.##...#.##.#.##.###...#.####.#..#.###
#...#####.##.#####.#.#.#.##.###.#.###.#.##.##..###
##.#.###..###.#.#.######..#..#.#.###.####.#####.##
##.#.#..#.##.#.#.#..#..#####..##...##.##.#.#..####
#.##.###..#.###.#.####.##.#..###.##..#########.###
###.##..##.#....#.....##..#.####.#.#####.##.##.###
#...#.#.######.#.##.##..##.#.###..##...#....#.####
##.##.##..###.#######.#.##.#.##.#.#.#.#.##..##.###
##...#..##..#.#.##..###..###.###.#.##.#.###.##.###
######.##########.##.####.###.###.#..#####.#.#.###
##################################################
