#...............#.....#..
.##.##.##.#.#.####.#.###.
.#.###.#.#...#..#...###..
.#..#.....#.#.#...##.#.#.
...#..#.##.##..##..#.#...
#.#.##...#....#..#....#.#
..#...##..#.#.##.#.#.#..#
.###.###.#.##..#...#.#.#.
..#...#.......#.#.#.#....
.#.##...#.###.#.#....#.#.
...#..#..#..#.#.#.##....#
.##..##.#.#..#..#.##.##..
.#.#.#.##...##.#....#..#.
.......#.##.#...#.##.#.#.
.###.##.....#.##........#
....###.#.#.#..##.#.##.#.
.#.#.#...###..#....###...
..#...#.#.###..##.#.#.##.
.#..#......##.#........##
.#.#.#.#.#.....#.#.#.##..
...#.#.#..#.#.#...###.#.#
.##...#..#.#.##.##.#..#..
.#..##.##.......##...#.#.
.#.#.....##.#.#....#.....
.....#.#.....#..##..##.#.
