###########################
#e..#....#.#......####.#..#
###...##....###.#..##....##
#..###.#.##....#.#....##..#
#.##....#.####.#...#.#.##.#
#....##........###.#.#....#
#.###..###.####...##.#.####
#....#....#.....#....#....#
###.#.#.#.#.####.####.#.#.#
#.#.....#...#.......#..#..#
#.#.####.###..##.##...#..##
#..#.........#..#.##.###..#
##...#.#.####.#....#..#.#.#
##.##.#.#...#...##..#.....#
#..#......#.#.##..#.#######
#.#..###.#..#...#.#.......#
#..#.#..#..#.##....####.###
##...#.#..#....###.#..#...#
#.###....###.###...##..##.#
#.....###.##.....##.#.#...#
#.##.#.......#.##.....#.#.#
#...#..##.#.#.....#.#..##.#
###.#.#..#.#.#####...##...#
#...#...#.........#.#...#.#
#.##.###..#####.#..#..##.s#
#........#.......#...#...##
###########################
