##########
#...#....#
#.#...##.#
#.##.#####
###.....s#
#e##.##.##
#..####..#
##.##...##
#.....#..#
##########
