##########
#.......##
####.##..#
#....##.##
#.##.#...#
#.######s#
#.#...####
#.#.#..#e#
#...##...#
##########
