##########
#.#....###
#e#.##..##
#.#####.s#
#..#..##.#
##...###.#
####..#..#
#..##...##
##....#..#
##########
