#########################
##.....###......###.....#
#e.###..#..#.##..#..##.##
####..#.#.##..#.#..#.#..#
#...#.#..#...#..#.#...#.#
#.#...#.##.##..#....#.#.#
#..##.#....#..#..###.#..#
##...#.####.#.#.#......##
##.#........#..###.#.#..#
#...#.###.#.##..#...#.#.#
##.#.#..#.#..#.#..#...###
#..#...#..#.#..#.#.##...#
##..#.#.#..#..###...#.#.#
#.#.#...#.##.#.#..#.#.#.#
#.#...#.#.#..#...#..##..#
#s.##..#..#.#.#.#.#..#.##
#.#..#.#.##.#...#..#.#..#
#...#..#....#.#.#.#..#.##
##.#..#.##.#.##.#.#.#...#
#..#.##...#.....#.#..#.##
##...#..#..###.#..#.#..##
###.#..#.#...#.#.##.##..#
##...#.#.###.#.#.....##.#
#..#...#.......#.#.#....#
#########################
