#########################
#.....#e.#......#..##...#
#####..#...#.##..#....#.#
#....#..#.#.#..#..#.##..#
#.##..#..#....#.#.#.#..##
#..##...#..#.#..#...#.#.#
##..####..#....#.####...#
###....#.#..##.#.....##.#
###.##...#.#....#.##..#.#
##..#.####..#.##...#.#..#
#..#......#..###.#..#..##
##.#.#.###.#..#..##...#.#
#..#.#......#...#.#.##..#
#.#...###.##.#.#...#...##
#..##.#...#...##.#...#..#
##..##..#...#...#.#.#..##
#.#..#.#..##..#....###.##
#..#.#..#..###.#.#..#...#
##....#.###.....#..#..#.#
#..#.#......#.#..#..#.#.#
#.###..#####..#.#.#.##..#
#..#..#.....#.#.#....#.##
##.###.#.##.###.#.##....#
#..s.....#......#...#.#.#
#########################
