#########################
#......#.#.##s#.......#.#
#.######....#...##.##...#
#....##..##...####..#####
#.##.#..#######..##.....#
#.##.#.##.#...#.#######.#
###..#.##...#.#......##.#
#...##..#.#.#.#.###.##..#
#.#..##...###.#.##...#.##
#.##########..#..#.###.##
#..#...#.#.#.###.#...#..#
##...#.....#..####.#.##.#
##.######.###...####..#.#
#..#...##..####.#.#..##.#
#.##.#..##..##......##..#
#.##.##..##....#######.##
#.#...##.#######........#
#.###.##..##...##.##.##.#
#...#..##.#..###..#...###
###.#.###...##...####..##
#.#.###...#.#..###..##..#
#.#..##.#.#.#.##...###.##
#.##.#..#.###.###.###...#
#......##..#e.#.......#.#
#########################
