#########################
#.....##....#....#...##.#
#####....##.#.##.#.#..#.#
#e..#######....#...##...#
##.##.....####.#######.##
#.....###..#...#...#.#.##
#######.##.#.#####...#..#
#s...#.....#.....###.##.#
###.##.#######.#..##.##.#
#...#..#..#..#.##....#..#
##.##.###...##.###.###.##
#..##.#...###..#.###...##
#.##..##.###..##..#..#..#
#..#.###.....##..##.###.#
#.##...#.######.###.#.#.#
#..###.#...#....##..#.#.#
##..##.###.#.#.##..##...#
###..#.#.#...###..###.###
#.##.#.#...####..##.#.#.#
#....#.#.#.#....###.#...#
##.###.#####.####.#.###.#
#..#...#...#.#.##.......#
##...###.#...#..#.#######
#..#.....#.#.##.........#
#########################
