#########################
#s#....##....##.........#
#...#.##..##.#..#######.#
#.###..#.###...##..#.##.#
#...##....#..#####......#
#.#########.##.#.#.######
#..##...#...#....#...#..#
##....###.#.#.#.####.#.##
#####..#..#.###....#...##
#.....##.#####..##.###..#
#.#.###..#...##..#...##.#
#.###...##.#..#####.##..#
#.#...#.#..##.....#..#.##
###.#####.#######.#.##.##
##...#......##..#.#.#...#
#..#.#.####..##.#.#...#.#
#.####.#..##....#.##.##.#
#..##..##..######..######
##....####.#....##.#....#
##.##.#....#.##..#...#.##
#...######.#..##.#####.##
#.#..##....#.##......#..#
#.##..#.##.#..######.##.#
#..##...#..##.e#........#
#########################
