#########################
#.#...#..#...#.#.#..#...#
#...#.#.#..#.#.....#..#.#
##.#......##.#####...#..#
#..#.###.#........###..##
#.#.#...##.######.....#e#
#...#.#...#......##.#.#.#
#.##...##...####.#.#..#.#
#....#..####...#.#...#..#
#.###.##...#.#.#..###..##
#.#....#.#...#...#...#..#
#.#.##.#..##..#.#..#..#.#
#.##....#..##..#..#.#...#
#....#.#.#...#..#.#..####
####..#...##..###.#.#...#
#...#...#.#..#....#...#.#
#.#..###..#.#..###..##..#
#..#.....#....#..##..#.##
##..#####.#.##..#...#...#
#.#.#......#...#..#.#.#.#
#.#..#.###...#...##.#.#.#
#s.#.##...#.#.#.##..#..##
#.#...#.#.##...##..###..#
#...#...#....#....#####.#
#########################
