#########################
#...#.####....###.#....##
#.#....##..##..#....##..#
#.####..#.####...######.#
#.#..##......##.##.##...#
#.##..######..###..#..#.#
#..#.##....##...##...##.#
##...#..##..###.#..######
####.##..#####..#.###...#
#..#..##.#...#.####...#.#
##.##.##...#.#..##..###.#
#...#..##.##.##....##...#
#.####..###..#######..#.#
#.##.##..###..#....#.##.#
#.#...##..###.#.##.#..#.#
#...#..##.#...#..#.##.#.#
##.##.##..#.####.#..#.###
#..#..#..##.#....##.#...#
#.##.##.###.#.##.#..##.##
#..#.##.##..#..####....##
##.#..#....###....##.#..#
#..#######..#####.#####.#
##..##...##.#...#...##..#
###....#s.....#.#.#.e#.##
#########################
