#########################
#..s...#..#.....#.#.#...#
###.##.#.##.###.....#.#.#
#...#....##...##.##...#.#
#.###.#.##..###..########
#...#####..##...##.....##
##.###....##..#.#..###..#
#...#..####..####.##.##e#
#.###.##..##...#..#...###
#.....#..##..#.#.####...#
#.##.###..#.####...#..#.#
###..#...##....###...##.#
##..##.#######...#####..#
#..##..#....###.##..##.##
#.####...##...#..#.##...#
#....##.###.#.##...#..###
####..###...#..###...##.#
#..##..####.##...#####..#
##..##....####.#.......##
###.#####..#...#.#####.##
###....###.#####.#...#..#
##..#.##......##.#.#.##.#
#..##....##.#....#.####.#
#.##..#.##..##.#.#......#
#########################
