########################################
#.......#...##e...#.#...#...#..##..#...#
##.##.#.#.#..####.#...#.#.#.##..##...#.#
#..#..###.##..##....#.#...#..##....#.###
#.##.##....##..#############..##.#.#..##
#.####..######.......##....##....####..#
#..#...###...##.###.##..#.#########.##.#
##...###...#..#.#...#..##..##...#.#..#.#
######...####.#.#.#.#.####..#.#.....##.#
#......###....###.###.#..##...###.#.#..#
##.######..####....#..##.######.###...##
#...##..#.###...##.#.###.#.#.....#######
#.#..##....#..#..###.......###.#......##
#.##.#..##.##.##...#######...#####.##..#
#.##.#####..#..###....##.###.#......##.#
#..#.....##.#####..##....#...#.######..#
##.#####..#..##...######.#.###.##...#.##
#....#.##.##....#.#....#.#..s#..###....#
####.#.##..#.######.####.###.##..##.####
#....#..##.###....#........#.###.#..#..#
#.#####..#...#.##.#######.##.#...#.###.#
#.#.....###.##..#......##.#..##.##...#.#
#.#.######...#.#######.#..#.###..#.#...#
#...#....###.#.#.#.....##.#...##.#####.#
#.#.#.##.##..#...#.###.#..###.#...#....#
###.#..#.#..##.###...####...#.###.###.##
##..##.#...##...####....#####.##..##...#
#..##..#####..#..#.####....#...#.##..#.#
#.####.......###......#.##...#...#..##.#
########################################
