########################################
#.#.......#...##....#s#....#...##.##.#.#
#...#.#####.#..##.###...##...#....#....#
#.#.#.##....##..#.#...#.#########...##.#
#.###....######...#.#.#.#......######..#
#..#######....###...###.#.#.####....#.##
#.##....###.#...#####...#.#..#...##....#
#..#.##...#.###....#..#.#.##...######.##
##...####.#...##.#.#.##.######.#...#...#
######....######.#.#..#..#...#.#.#.#.#.#
#...##.####...#..#.##.####.#e#.#.#.#####
##.##..##...#...##.##..#...#####.#.....#
##.#..##..#####.####..##.#.##....####.##
#..#.##..##...#.#.#..###.###..####.#...#
#.##.#..###.#.#...#.##....#..###.....###
#..#.#.##.#.#####.#.#####.#.##.#.#####.#
#.##.#.#....#...#.#..##.#...#..#.#.....#
#....#.####...#...##....######.#.##.####
#.####....#######..###.##......#..#....#
#...#####..#....##..##....##.#.##.#.##.#
###....###...##..##..##.########..####.#
#.####..######..###.##...##.#....###...#
#.##.##.#......###...###..#.#.#####..#.#
#.#..#..###.####.#.###.##...#.#.....##.#
#...##.###..#.##.#...#..###.#.##.#.###.#
#.####.#.#.##....###.##..#..#..#.#.#...#
#.#....#...###.#...#.###.#.###.###.##.##
#.#.######.#...#####...#.#.#.......#...#
#..........#.#.......#...#...#.#.#.#.#.#
########################################
