########################################
#.##.#.#...#...##.#.#...##..e..#..#.##.#
#.#....#.###.#......#.#..#####.##....#.#
#...##.#..#..##.#####.##..#.#..#..##...#
#.###..##...##..#.....###...#.##.#####.#
#..##.##..#.#..##.#####.###...#.....##.#
##.#..#..####.###...##...##.#########..#
##.#.#####.#....###..#.#..###.....##..##
#..#.....#...##...##.#.##..#..###.#..###
#.######.##.#####.##.#####...##.#...####
#.#....#..#.##.....#.#.....###..###...##
#...##.##.#..#######.#.#####.#.##.###..#
#####..#..##..#......#..#.........#.##.#
#.....##.##..##.#######.#######.#....#.#
#.#####.....###..#....#..#....#.##.###.#
#.....#####.#.##...##.##...##.#.##...#.#
#.###....#.....######..##.##..###..#...#
#...#.##.########...##..####.###..######
#####.#..##.......#..##.#....#.##..#.#.#
#...###.##..########..#...####..##.....#
#.#.....##.###...#...######..##.####.#.#
#.####.##..#.#.#...#.#......##.....###.#
#....###..##.#.#####...####.##.###..#..#
#.##.....##..#....######.....#...##...##
#.##########.####.#.##...#.#s###..######
#.#..#...#...##.#.#....#######...##.##.#
#.##...#.##.##..#.#.#.##...##..#....#..#
#..###.#..#.#..##.######.#....#####...##
##.....##.....##.........#.#.##.....#..#
########################################
