##############################
##...#.....#.#.....#...#.#.#.#
#..#...###.#...###.#.#.......#
#.#######..#.#..#..#.######.##
#..#....####.##.####......#..#
#.##.##...##.##...######.###.#
#..#.####..#..#.#.#........#.#
##...#..##...##.#...########.#
##.###.#####..#######......#.#
#..#....##.####...#...####...#
##.####....#....#...#.#....#.#
#.....##.###.####.#.#.######.#
#####.##...#....########...###
#..#..#..#.####.##.....#.#..##
#.##.##.##..#...#..#.#...##..#
#.#...###..##.###.##.###.###.#
#.#.###...###.....#####....#.#
#.......#...#######...#.##.#.#
#.#######.#.....##..#.#..###.#
###...##..##.#.##..##.##.#...#
#...#.#..#######..###.##.#.###
##.##.#####......###...#.#...#
##.#......#.######.###.###.#.#
#..######.#....##....#...#.#.#
#e##.##.#.#.##.#..#.####.###.#
###...#.#.#.#..####.#..#..#..#
#s..#.....###.###...##.##...##
#.##########..#...#..#..###..#
#..##........##.####.##.#.##.#
##....########...##...#...#..#
#######.#...##.#..###.###.#.##
#..##.....###..##..##.....#..#
#.##..##.##...####..#####.##.#
#....###....###..##...##..#..#
#.####.######.##.####..##.#.##
#.##...##......#.#..##..###.##
#..#.#..####.#...##..##.##...#
##...##..##..###.###..#....#.#
#..#..##....##.......##.#.##.#
##############################
