##############################
#...#.#..s#.....##....##.#...#
##.##...#...###..##.#......#.#
##....#.###.#.##..#.###.####.#
#..#.####...#..##.#...#..#...#
##.####...#.##....#.#.##.#####
#...##..#.#.##.######.##.....#
#.###..######.......###..###.#
#.#.#.###...#######...##...#.#
#.#.#.##..#..#...##.#..#####.#
#...#....###...#..####.#...#.#
###.######.######..#.....#.#.#
#...#......#.#.###.#.#.###.#.#
#.###.####.....#.#.#####.....#
#.##.....##.##...#.....#######
#..#####.##.####.#####..#....#
##...#.#..#....#.....##.#.#.##
####.#...#####.##.#####...#..#
#..#.###.#...#..###...#####.##
##.#.##..#.#.##...#.#....##..#
#..#..#.##.#..###.#.####..#.##
#.###.#.#..#####..#....##....#
#.#...#...##.....#####..####.#
#.#.###.###..###.#...##...####
#.#...###...##.#.#.######...##
#.###..##.###....#......#.#..#
#...##..#..####.###.#.#.####.#
##.####.##..##....#.#.###....#
##....#..##..####.#.#..#e.####
#..#.###..##.#....####.#####.#
#.##.####.##.#.####....#...#.#
#.##..##.....#.##.#.##...#.#.#
#..##..#######......######...#
#.####...#...########..#.###.#
#..#.###...#...#.##...##...#.#
##.#.#.##.######....#.#..#...#
#..#....#...#....####.#.######
##.####.##.##.#####.#...#.#..#
#........#..........#.#.....##
##############################
