##############################
#...##.....#...#....#.s.#....#
#.#..###.#.#.#...##...#.##.###
#.##..#..#.####.#######..#...#
#..##...##..##..#.....##.##.##
######.####.#..###.#.###.##..#
##.....#......##...###...#..##
#..#.#.#.######..#..##.###.###
#.#########...##.##......#...#
#.###...#.#.#..####.#.##...#.#
#..#..#.....##....############
##.#.############.......#....#
#..#..##..#...#.#####.###.#.##
#.###..##...#.......#.....#..#
#..###..######.#.###########.#
##..###..#...#.#.#.....##..#.#
###..###.#.#.###...#.###..##.#
#.##.......#...###.#..#..##..#
#..#####.#.#.#...####...##..##
#.##...#######.#..#...#..##..#
#....#..#....####...#.#.##..##
##.####...##...###.######..###
#..#..#######.##...#......##.#
#.###.......#..#####.####.##.#
#.#.##.###.###.##....#.......#
#...#..##..#...#..#.#######.##
###.##..####.###.####.....#..#
##...##....#...#......#.#.##.#
#..###..##.###e##.#######.#..#
##.##..##....###.....##...##.#
#..#..######.....#####..###..#
##.#.###...#####..#....##.##.#
#..###...#.....##.#.#####....#
#.##...#######..###..##.#.####
#....###....###...##..#.....##
######...##...###.###.#####..#
#...#..#..######....#..#.###.#
#.#.#.###....#.####.##.#.#...#
#.#.....#.##...........#...#.#
##############################
