##################################################
#....#...##....#....#e.#....#...##.#.#.#.#.#.....#
#.##...#..#.##...#.###.##.###.#....#.......#####.#
#..######.#..#####..##.#......##.###.##.##.#...#.#
##...#......##..##.##..#.#######..#...#..#...#.#.#
##.#.########..##..#..##....#..##...####.#####...#
#..#..##....#.##..##.####.#...##..#...#..#.#.###s#
#.###....##.#....##..#....#####..######.##....##.#
#..#######..#.####..##.####...##...##...#..#.##..#
##.....##..##.##...###.#....#..#.###..######.##.##
#####.##..###..#.###.#.#.#####.###...##......#...#
#...###..##.##.#...#...#.#...#..#..####.#.##.#.###
#.#.##..###.##.###.#####...#.##...###...#.####.#.#
#.#....##.#......#.#...###.#..######..#.#..#...#.#
#.#######...######...#...###.##...#..#####.#.###.#
#.#.#..#..###...########..##..#.#.#.####...#.##..#
#.#...##.##.###.#...##.##..##...#.#.###..#.#..##.#
#.#.###..#...#..#.#.....##..#####.#..#..##.##.##.#
#.#.#...##.#...##.##.######...#...#.##.###..#....#
#.#.#.###..##.###..#.#....###.#.###.#..#.##.#.##.#
#.#.#..#####....##.#...##..##.#..#..#.##....#..###
#.#.##..#....##.##.######.##..##.#.##.########..##
#.#..##...#####..#..#...#.##.##..#.#..#......##..#
#.##.#..###...##.##.###.#.#..#..##.#.##.###.####.#
#.#....##...#.....#.....#...###..###.##.##....#..#
#.######..#.###########.#####.##..#......#.####.##
#......####..##.......#...#...###.##.#####..#....#
#.####....##..#.#.#######.###.#....###...##...#.##
#.#..###.###.##.#.........#...####.#...#..#####..#
#.##...#...#.#..###########.#....#.#.####....###.#
#..##.####.###.##..#...##...####...#....#.##.#.#.#
##.##.#.#..##...##...#..#.###..##.#####.###..#...#
#..#....#.##..#########....###.#...#.....##.##.###
#.##.##.#....##.#...#.##.#.#.....###.#.#.#..#....#
#.#...########....#....###.#####.#...#####.##.####
#.###..##....#.#######..#......###.#..#....#....##
#...##....##.....#.#.##.###.##.....####.#######..#
##.##..##.######.#....#...###..#####....#...#.##.#
#..#..##......##.#.#.####...#.##.....####.#....#.#
#.#####..#.####..#.#....###.#.##.#####....#.#.##.#
#...##..####....####.#.##...#..#.#...###.##.#.#..#
###..####....####....#.#..####.#...#...####.#.#.##
#.##..#...####....####.#.##..#######.#....###....#
#..##...###..#.##...#..#..##.##...#####.#.##..####
##..#####.#.##.####.##.##.#..#..#.....###..#.##..#
###.........#..#.##..###..##...######..###.#.#..##
##..##.######.##..##..#..####.##...###.#.#.#.##..#
#..###...##....##..##.#.###.#.##.#.#.....#.#..#.##
#.##...#....##....##..........#..#...#.#...##....#
##################################################
