##################################################
#......##..........##...##..#...#.....#...#...#..#
#.####.#..#.##.##.##..#..#.##.#...###...#.###...##
#.#....#.##.#...###..###...##.###...#####...#.#.##
#.#.##.###..#.###...##.###.#...####.#.#...#.#.#..#
#.#.#...##.##...##.###...#...#...##.#...###.####.#
#.#.###..###..#........#######.#..#.##.###..#....#
###.#.##...##.###########...#####.#..####..##.####
##..#.####.#.....##...#...#.#.#...##..##..##.....#
#..##...#..#.##.##..#.##.##...#.#..##.#..##..#.#.#
#.####.##.#######..##.#...###.#.####..#.######.#.#
#.#.....#.....##..###...###...#..#...##.#...####.#
#.#.##.######....##.######..###.##.###....#.#....#
#.#..#.....#######...##..#.##....#..##.##.#...##.#
#.##.#####.........#....##..#.##.##..###########.#
#.##.##..#######.######..##.########.......#...#.#
#.#..#..###.#..#..#...##..#.##.....#.###.###.#.###
#.##.#.##.....##.##.#..##.#....###.####...#..#...#
#.#.......###..#....##.##.######.#....#.###.###.##
#.##########..#######..#..#.#....####.#......##..#
#..#.......#.##....###.####...#.###.#.####.###..##
#.##.#.###.###..##..#.....#.###.....#..##....#.###
#....###...#...####.#####...#.##.#####..###.##...#
#.####...#.#.###..#....#..###..#...#.##..####..#.#
#.##...#####.....##.##.#.##...####....##..##..##.#
#..#.###...###.#..###..#.#..#....##.#.###....##..#
#.##.#...#.....##..##.##...#######..#..###.#.#..##
#.#..#.##########.##...###.#.#...#.###..##.#######
#.#.##..#...#...###..####..#...#...#...##...#...##
###.###...###.#..#..##.#..##.#.###.#.###..###.#..#
#...#.##.###..##.##.##.#.###.#..#######..##...##.#
#.#...##.#...###.#...#.#...#.####.......##..####.#
#.#####..#.####..###.#.##.##.#....#######..###.#.#
#..##...##.#..#.###..#.....#...#####.#....##...#.#
##....####.##.#.#...##.#########.....#.####..#.#.#
#..####....#..#...####..##.......#.#.#.#.#..####.#
##..#...#####.#####..##..#.##.######.#...##....#.#
#..##.###...........####...#...#...#.###..####.#e#
####..#...#.#.#.#####....#.#####.#.#...##...#..###
#....##.#.###.###.....######.....#.########...##.#
#.#######...####..#.####...##.####..#.....###.##.#
#.......###...#..####....#.#.....##.#.###..#..#..#
#.#####..#..#...##.#..####...#.###..#.#.#.##.##.##
#..#..##.#########...##.########...##...#....#...#
##.##..#.....#...##.##......#....#.###.#######.#.#
#...##.#####...#..#.#..##.#.#.##.###...#.......###
###.##....#######.#.####..#.#.##..#..#########...#
#.#.#..#.##....##....##..##.#..####.##......####.#
#.....##....##..#.##....##..##....s....##.#......#
##################################################
