##################################################
#...#...##....##.#...#.#.#.......#...##....##....#
#.###.#....##....###.....##.###.##.#..#.##..#.#.##
#.##..#.######.#...##.##..#.#.#.#..##...###...#..#
#.#..#####...#.#.#.....##...#.#.#.#######.######.#
#...##...#.#.#.##############.#.#.##...#....#..#.#
#.###..#...#...#........#...#...#....#.#.##...##.#
#.##..##########.######.#.#.#.########.#####.##..#
#..#.##...###.....##..#.#.#.....#....#..#.#...#.##
##.#....#..#..#####..##.#.#####.#.#.###...##.##..#
##.#######...###.#..##..#.#...###.#.....#.....##.#
#...#..#.#####.....##..##.###..##.#############..#
###.##.........##.##..###...##.#..#..........#..##
#.#.#..#.#####..#.#..##.###.##.#.##.#####.##...###
#.#.####.....##.#.#.##...#...#.#..#.#...###..###.#
#.#...####.####.#.#.#..#...#...##.#...#...####...#
#.###.#....#....#.#.#########.##..#######...#..#.#
#.#.#.####.#.####.#....#....#..##.#..#..###...##.#
#...#..##..#...#..####...##.##..#.##...##.######.#
##.###..##.###.#.##.#######..##.#.##.#..#.##...#.#
#....##..#..#..#..#.#.....##..###....##.#.#..#.#.#
#.######.##.#.###...#.###.###...#######...#.####.#
#......#..###.#.###.#..##.#.##.##.##..###.#..#...#
#.###.###...#.#.#.#.##.#....##....#..##.....##.###
#.#.#...###...#...#....#.##..##.#.#.#######..#..e#
#...###.#.###.###.######..####..#.....##..#.######
###...#.#...###....#.#.#.###...######..##.#.#...##
#.###.#...#..#..####.....#...###.#..##..#.#.#.#..#
#.....######...##....#####.#.#...#.####.#...#.####
###.####.#...#..#.####.....###.#.#....#.#.###....#
##...#...#.#.##.#..#...######..#.##.###.#.#.#.#.##
#..#...###.#######.#.###......##.##.#...#.#...#..#
#.#######..##....#.#.#.#.#.####...#.#.###.#####.##
#..##.....##..##...#.#...#..##..#...#.#.#...#....#
#.##..#.#..#.#######.###.##..######.#...###.##.#.#
#.#..####.##..#....#..#...##.....######...#..#.#.#
#.#.####...##.#.#####.#####..###......###.##...#.#
###.#.#..#.##.#...##.....#..##.#####.##.#..#####.#
#...#...##.#..#.#..#####.##....#.#.#..#.##.#...#.#
#.###.###..#.##.##.....#..####.#...##....#...###.#
#.##...##.##.########.###....#...#..####...#..#..#
#..###..###..#.....##...####.######.#..#.####.#.##
##...##..#..###.##..#.#.##...##.......##....###.##
##.#.#####.##...###...###..#..################...#
#..#..##...##.#.#.###..##.###.#...#...#.#....#.###
##.##....###..###...##.#..#.###.#...#...#.##.#.#.#
#...######...###..#....#.##.....######.##..#...#.#
#.#..##....###...#######..#.######.#.#.###.#####.#
#.##....##.#...#.......##............#s..........#
##################################################
